"filename", "language", "Python", "Properties", "comment", "blank", "total"
"c:\Users\oliver\Documents\code\tower-defence-project\config.cfg", "Properties", 0, 10, 4, 4, 18
"c:\Users\oliver\Documents\code\tower-defence-project\engine\__init__.py", "Python", 11, 0, 0, 0, 11
"c:\Users\oliver\Documents\code\tower-defence-project\engine\entity.py", "Python", 51, 0, 0, 10, 61
"c:\Users\oliver\Documents\code\tower-defence-project\engine\game.py", "Python", 251, 0, 11, 48, 310
"c:\Users\oliver\Documents\code\tower-defence-project\engine\particle_system.py", "Python", 21, 0, 0, 5, 26
"c:\Users\oliver\Documents\code\tower-defence-project\engine\screen.py", "Python", 44, 0, 0, 8, 52
"c:\Users\oliver\Documents\code\tower-defence-project\engine\screen_manager.py", "Python", 37, 0, 0, 7, 44
"c:\Users\oliver\Documents\code\tower-defence-project\engine\sound.py", "Python", 19, 0, 0, 5, 24
"c:\Users\oliver\Documents\code\tower-defence-project\engine\theme.py", "Python", 79, 0, 7, 15, 101
"c:\Users\oliver\Documents\code\tower-defence-project\engine\ui.py", "Python", 355, 0, 29, 61, 445
"c:\Users\oliver\Documents\code\tower-defence-project\entities\__init__.py", "Python", 5, 0, 0, 0, 5
"c:\Users\oliver\Documents\code\tower-defence-project\entities\bullet.py", "Python", 15, 0, 0, 3, 18
"c:\Users\oliver\Documents\code\tower-defence-project\entities\enemy.py", "Python", 111, 0, 0, 18, 129
"c:\Users\oliver\Documents\code\tower-defence-project\entities\player.py", "Python", 110, 0, 4, 20, 134
"c:\Users\oliver\Documents\code\tower-defence-project\entities\tower.py", "Python", 130, 0, 5, 14, 149
"c:\Users\oliver\Documents\code\tower-defence-project\entities\upgrade.py", "Python", 49, 0, 0, 9, 58
"c:\Users\oliver\Documents\code\tower-defence-project\game\game.py", "Python", 247, 0, 0, 38, 285
"c:\Users\oliver\Documents\code\tower-defence-project\game\level.py", "Python", 136, 0, 0, 38, 174
"c:\Users\oliver\Documents\code\tower-defence-project\main.py", "Python", 43, 0, 4, 10, 57
"c:\Users\oliver\Documents\code\tower-defence-project\screens\__init__.py", "Python", 5, 0, 0, 0, 5
"c:\Users\oliver\Documents\code\tower-defence-project\screens\game_select.py", "Python", 42, 0, 3, 15, 60
"c:\Users\oliver\Documents\code\tower-defence-project\screens\heroes.py", "Python", 80, 0, 3, 11, 94
"c:\Users\oliver\Documents\code\tower-defence-project\screens\menu.py", "Python", 18, 0, 3, 7, 28
"c:\Users\oliver\Documents\code\tower-defence-project\screens\settings.py", "Python", 33, 0, 5, 11, 49
"c:\Users\oliver\Documents\code\tower-defence-project\screens\upgrades.py", "Python", 13, 0, 0, 4, 17
"c:\Users\oliver\Documents\code\tower-defence-project\util\__init__.py", "Python", 3, 0, 0, 0, 3
"c:\Users\oliver\Documents\code\tower-defence-project\util\constants.py", "Python", 8, 0, 1, 3, 12
"c:\Users\oliver\Documents\code\tower-defence-project\util\functions.py", "Python", 0, 0, 0, 1, 1
"c:\Users\oliver\Documents\code\tower-defence-project\util\types.py", "Python", 2, 0, 0, 1, 3
"Total", "-", 1918, 10, 79, 366, 2373